OOOOOOOOOOOOOOOOOOO
Oc--ooooooooooooooO
O-XoXoXoXoXoXoXoXoO
O---------------ooO
O-XoXoXoXoXoX-X-XoO
O-ooo-ooooooo-o---O
O-XoX-XoXoXoX-XoX-O
O-o--c------------O
O-X-XoXoXoXoXoX-XoO
O-o-ooooooo-ooo-ooO
O-X-XoXoXoX-XoX-XoO
O-o-ooooooo-----ooO
O-X-XoXoXoXoXoXoXoO
O-o---o-----------O
O-XoX-X-XoXoXoXoX-O
O-ooo---ooooooooo-O
OoXoXoXoXoXoXoXoX-O
O-c-------------c-O
OOOOOOOOOOOOOOOOOOO
